------------------------------
------------------------------
------------------------------
------------------------------
-----###########--------------
-----#---------#--------------
-----#---------#--------------
-----#-------###--------------
-----#-------#------############
######-------########---------
------------------------------
------------------------------
------------------------------
------------------------------
------------------------------